11111111111111111111111111111111111111111111111111
12444444444444444444444444444444444444444444444441
14141111114111111111111111111111111114141414144441
14141444444444444444444444444444444444141414111141
14141411114111111111111111111111111114141414144441
14144414444440444444444444444444444444141414144141
14141414141410111111111111111111111414141414144141
14141414141410000000144414441444444414141414441141
14141414141410000000141444144144144414141414144141
14141414141410005000141411111144141414141414114141
14141414141000000000041414444444141414141414144141
14141414141111000000141414414141111414141414144141
14141444444444000000141444414444444444441414114141
14141414141414141111111111111111111414111414144141
14141414141414141444444444444444441414141414444141
14141414141414141411111111111111141414141414114141
14141414141414141444441444111444141414141414144141
14141414141414141414141414141414141414141414144141
14141414141414141414141414141414141414141414144141
14141414141414141414141414144414141414141414144141
14141414141414141414141414141414141411141414141141
14141414141414144414141414141414141444441444144441
14141414141444111414141414141414141414111111111141
14444444444414444414144414441414444414444444444431
11111111111111111111111111111111111111111111111111